############################
#           #   #          #
##########  #   #          #
#           #   #######  ###
# ######    #              #
#      #    #   #######   ##
#####  #    #   #         ##
       #        #     ######
############################